#################
###############E#
##########   ## #
###        #    #
### #############
### ##   ##   ###
### ## # #  # ###
### #  #   #   ##
###   #### # #  #
##########  #####
########### #####
###########   ###
####   ######  ##
#### # #    ## ##
##   # # ## #  ##
#  ###   ##   ###
#S###############
#################
